RELATÓRIO DE CONVERSÃO GITBOOK → PDF
==================================================

Data da conversão: 24/07/2025 às 15:55:43
Total de páginas convertidas: 96

PÁGINAS POR SPACE:
------------------------------

Untitled (1 páginas):
  - Page → Untitled_Page.pdf

Faq Interno (1 páginas):
  - Page → Faq_Interno_Page.pdf

Portal do Produtor (51 páginas):
  - Bem Vindo(a) → Portal_do_Produtor_Bem_Vindo(a).pdf
  - Dúvidas Frequentes → Portal_do_Produtor_Duvidas_Frequentes.pdf
  - Portal do Produtor → Portal_do_Produtor_Portal_do_Produtor.pdf
  - Fluxo de Inscrição → Portal_do_Produtor_Fluxo_de_Inscricao.pdf
  - Conheça o portal do produtor → Portal_do_Produtor_Conheca_o_portal_do_produtor.pdf
  - Cadastro → Portal_do_Produtor_Cadastro.pdf
  - Primeiro Acesso → Portal_do_Produtor_Primeiro_Acesso.pdf
  - Novo Usuário → Portal_do_Produtor_Novo_Usuario.pdf
  - Dashboard - Guia Completo → Portal_do_Produtor_Dashboard_-_Guia_Completo.pdf
  - Produto → Portal_do_Produtor_Produto.pdf
  - Cadastro de Produto → Portal_do_Produtor_Cadastro_de_Produto.pdf
  - Ofertas → Portal_do_Produtor_Ofertas.pdf
  - Gestão de Link → Portal_do_Produtor_Gestao_de_Link.pdf
  - Renovação Automática → Portal_do_Produtor_Renovacao_Automatica.pdf
  - Integrações → Portal_do_Produtor_Integracoes.pdf
  - Vendas → Portal_do_Produtor_Vendas.pdf
  - Financeiro → Portal_do_Produtor_Financeiro.pdf
  - Etapas do Checkout → Portal_do_Produtor_Etapas_do_Checkout.pdf
  - Notazz → Portal_do_Produtor_Notazz.pdf
  - Cadastro do Pixel na Página de Checkout → Portal_do_Produtor_Cadastro_do_Pixel_na_Pagina_de_Checkout.pdf
  - Spedy → Portal_do_Produtor_Spedy.pdf
  - Active Campaign → Portal_do_Produtor_Active_Campaign.pdf
  - TMB API → Portal_do_Produtor_TMB_API.pdf
  - Page 1 → Portal_do_Produtor_Page_1.pdf
  - Central de Vendas → Portal_do_Produtor_Central_de_Vendas.pdf
  - Vendas → Portal_do_Produtor_Vendas.pdf
  - Reenvio de Vendas → Portal_do_Produtor_Reenvio_de_Vendas.pdf
  - Cancelamento de Pedido → Portal_do_Produtor_Cancelamento_de_Pedido.pdf
  - Recuperação de Vendas → Portal_do_Produtor_Recuperacao_de_Vendas.pdf
  - Rastreamento de Vendas → Portal_do_Produtor_Rastreamento_de_Vendas.pdf
  - Cancelados → Portal_do_Produtor_Cancelados.pdf
  - Finanças e Contratos → Portal_do_Produtor_Financas_e_Contratos.pdf
  - Carteira → Portal_do_Produtor_Carteira.pdf
  - Contas a Receber → Portal_do_Produtor_Contas_a_Receber.pdf
  - Taxas → Portal_do_Produtor_Taxas.pdf
  - Relatório Financeiro → Portal_do_Produtor_Relatorio_Financeiro.pdf
  - Extrato Anteriores → Portal_do_Produtor_Extrato_Anteriores.pdf
  - Nota Fiscal do Aluno → Portal_do_Produtor_Nota_Fiscal_do_Aluno.pdf
  - Como cadastrar minha conta bancária → Portal_do_Produtor_Como_cadastrar_minha_conta_bancaria.pdf
  - Dashboard → Portal_do_Produtor_Dashboard.pdf
  - Coprodução → Portal_do_Produtor_Coproducao.pdf
  - Termo de Aceite de Condições → Portal_do_Produtor_Termo_de_Aceite_de_Condicoes.pdf
  - Termo de Encerramento de Relação de Coprodução → Portal_do_Produtor_Termo_de_Encerramento_de_Relacao_de_Coproducao.pdf
  - Conta → Portal_do_Produtor_Conta.pdf
  - Participações e Comissões → Portal_do_Produtor_Participacoes_e_Comissoes.pdf
  - Configurações → Portal_do_Produtor_Configuracoes.pdf
  - Produtores → Portal_do_Produtor_Produtores.pdf
  - Recebimentos → Portal_do_Produtor_Recebimentos.pdf
  - Usuários e Permissões → Portal_do_Produtor_Usuarios_e_Permissoes.pdf
  - Conta → Portal_do_Produtor_Conta.pdf
  - Central de Comunicação → Portal_do_Produtor_Central_de_Comunicacao.pdf

Portal do Cliente (38 páginas):
  - Bem vindo (a)! → Portal_do_Cliente_Bem_vindo_(a)!.pdf
  - Dúvidas Frequentes → Portal_do_Cliente_Duvidas_Frequentes.pdf
  - Como funciona o boleto parcelado? → Portal_do_Cliente_Como_funciona_o_boleto_parcelado.pdf
  - O que é necessário para solicitar o boleto parcelado? → Portal_do_Cliente_O_que_e_necessario_para_solicitar_o_boleto_parcelado.pdf
  - Posso alterar a data de vencimento das parcelas? → Portal_do_Cliente_Posso_alterar_a_data_de_vencimento_das_parcelas.pdf
  - Posso ter mais de um financiamento com a TMB Educação? → Portal_do_Cliente_Posso_ter_mais_de_um_financiamento_com_a_TMB_Educacao.pdf
  - Não moro no Brasil, consigo solicitar o financiamento? → Portal_do_Cliente_Nao_moro_no_Brasil,_consigo_solicitar_o_financiamento.pdf
  - É seguro enviar meus documentos digitalmente para a TMB Educação? → Portal_do_Cliente_E_seguro_enviar_meus_documentos_digitalmente_para_a_TMB_Educac.pdf
  - Análise de crédito → Portal_do_Cliente_Analise_de_credito.pdf
  - Qual é o critério da análise de crédito? → Portal_do_Cliente_Qual_e_o_criterio_da_analise_de_credito.pdf
  - O que é um Avalista ? → Portal_do_Cliente_O_que_e_um_Avalista_.pdf
  - Como Indicar um Avalista? → Portal_do_Cliente_Como_Indicar_um_Avalista.pdf
  - Sou avalista, como confirmo a indicação? → Portal_do_Cliente_Sou_avalista,_como_confirmo_a_indicacao.pdf
  - Inscrição → Portal_do_Cliente_Inscricao.pdf
  - Recebi uma mensagem de "Dados Inválidos"  na inscrição, e agora? → Portal_do_Cliente_Recebi_uma_mensagem_de_Dados_Invalidos_na_inscricao,_e_agora.pdf
  - Não recebi o código de verificação no whatsApp, o que fazer? → Portal_do_Cliente_Nao_recebi_o_codigo_de_verificacao_no_whatsApp,_o_que_fazer.pdf
  - Como faço para enviar os meus documentos? → Portal_do_Cliente_Como_faco_para_enviar_os_meus_documentos.pdf
  - Sai do processo de financiamento, como voltar ? → Portal_do_Cliente_Sai_do_processo_de_financiamento,_como_voltar_.pdf
  - Seu CPF já está cadastrado com a TMB? → Portal_do_Cliente_Seu_CPF_ja_esta_cadastrado_com_a_TMB.pdf
  - Contrato  → Portal_do_Cliente_Contrato_.pdf
  - Como recebo meu contrato? → Portal_do_Cliente_Como_recebo_meu_contrato.pdf
  - Como assinar o seu contrato digitalmente? → Portal_do_Cliente_Como_assinar_o_seu_contrato_digitalmente.pdf
  - Boleto de entrada → Portal_do_Cliente_Boleto_de_entrada.pdf
  - Como recebo o boleto de entrada? → Portal_do_Cliente_Como_recebo_o_boleto_de_entrada.pdf
  - Preciso pagar o boleto de entrada imediato? → Portal_do_Cliente_Preciso_pagar_o_boleto_de_entrada_imediato.pdf
  - Posso alterar a data de vencimento do boleto de entrada? → Portal_do_Cliente_Posso_alterar_a_data_de_vencimento_do_boleto_de_entrada.pdf
  - Posso solicitar um novo boleto de entrada caso não efetue o pagamento a tempo? → Portal_do_Cliente_Posso_solicitar_um_novo_boleto_de_entrada_caso_nao_efetue_o_pa.pdf
  - Acesso ao produto → Portal_do_Cliente_Acesso_ao_produto.pdf
  - Como faço para acessar o produto?  → Portal_do_Cliente_Como_faco_para_acessar_o_produto_.pdf
  - Portal do Aluno → Portal_do_Cliente_Portal_do_Aluno.pdf
  - Como recuperar minha senha do portal do aluno? → Portal_do_Cliente_Como_recuperar_minha_senha_do_portal_do_aluno.pdf
  - Quero a 2ª via do boleto parcelado, onde encontro? → Portal_do_Cliente_Quero_a_2a_via_do_boleto_parcelado,_onde_encontro.pdf
  - Posso antecipar o pagamento das parcelas? → Portal_do_Cliente_Posso_antecipar_o_pagamento_das_parcelas.pdf
  - Cancelamento → Portal_do_Cliente_Cancelamento.pdf
  - Qual é o prazo de cancelamento? → Portal_do_Cliente_Qual_e_o_prazo_de_cancelamento.pdf
  - Como faço para cancelar meu parcelamento por boleto? → Portal_do_Cliente_Como_faco_para_cancelar_meu_parcelamento_por_boleto.pdf
  - Como preencher o link de estorno? → Portal_do_Cliente_Como_preencher_o_link_de_estorno.pdf
  - Política de Privacidade → Portal_do_Cliente_Politica_de_Privacidade.pdf

Api Core TMB Educação (5 páginas):
  - Bem vindo(a) → Api_Core_TMB_Educacao_Bem_vindo(a).pdf
  - API → Api_Core_TMB_Educacao_API.pdf
  - ZenDesk → Api_Core_TMB_Educacao_ZenDesk.pdf
  - Documentação → Api_Core_TMB_Educacao_Documentacao.pdf
  - Status do Pedido → Api_Core_TMB_Educacao_Status_do_Pedido.pdf
